###################
#S.....#..#..#....#
###.#.##.#.##.#.###
#...#....#....#...#
#.###.##...##.###.#
#.....#..#......#.#
#.#.###.##.#.#.#.##
#.#.##...#........#
#.#....#####.#.#.##
#.#.####.....#.#.##
#.#.#######.##.#.##
#.#............#.##
#.######.##.####.##
#........#.......##
#######E###########
###################